1111111111111
10000000P0E01
1110111111111
1000001000111
1011111111111
100000C000001
1111111111111