1111111011111
1P000011000E1
1110111111101
1C00001P000C1
1011101111101
1C0000C000001
1111111111111