1111111111111
1000000C00E01
1001111111111
1000C1100000
100000000P001
1111111111111