1111111111111
10000011000E1
1110111111111
1C00P010001C1
1011101111111
1C0000C000001
1111111111111